Sokoban - Level 2
XXXXXXXXXXXXXXXXXXX
X@@..X.....XXXXXXXX
X@@..X.*..*..XXXXXX
X@@..X*XXXX..XXXXXX
X@@....!.XX..XXXXXX
X@@..X.X..*.XXXXXXX
XXXXXX.XX*.*.XXXXXX
XXX.*..*.*.*.XXXXXX
XXX....X.....XXXXXX
XXXXXXXXXXXXXXXXXXX
XXXXXXXXXXXXXXXXXXX
Congratulations !