Sokoban - Level 1
XXXXXXXXXXXXXXXXXXX
XXXXX...XXXXXXXXXXX
XXXXX*..XXXXXXXXXXX
XXXXX..*XXXXXXXXXXX
XXX..*.*.XXXXXXXXXX
XXX.X.XX.XXXXXXXXXX
X...X.XX.XXXXX..@@X
X.*..*..........@@X
XXXXX.XXX.X!XX..@@X
XXXXX.....XXXXXXXXX
XXXXXXXXXXXXXXXXXXX
LEVEL2.SOK